







************************************************
************************************************
************************************************
************************************************
************************************************
************************************************
************************************************
************************************************
************************************************
************************************************
************************************************
************************************************
************************************************
************************************************
************************************************
************************************************
************************************************
****S**************************************E****
************************************************
************************************************
************************************************
************************************************
;;;;;;;;;;;;;;;;;;;;;;;;;;;;;;;;;;;;;;;;;;;;;;;;
OOOOOOOOOOOOOOOOOOOOOOOOOOOOOOOOOOOOOOOOOOOOOOOO